,HTP,ATP,DiffPts,DiffFormPts,DiffLP,HTGD,ATGD
30,4,5,-1,-1,6.0,0,1
31,7,2,5,5,2.0,2,-3
32,0,4,-4,-4,0.0,-6,2
33,1,3,-2,-2,6.0,-6,-1
34,3,3,0,0,-8.0,-3,-1
35,5,7,-2,-2,4.0,1,5
36,7,4,3,3,-8.0,4,3
37,5,5,0,0,-13.0,1,1
38,7,3,4,4,-16.0,5,-3
39,5,4,1,1,7.0,1,0
40,3,6,-3,-3,-1.0,-2,1
41,5,6,-1,-1,-6.0,0,1
42,7,10,-3,-3,-12.0,3,3
43,8,4,4,4,3.0,4,-2
44,8,6,2,2,1.0,2,-2
45,4,6,-2,-2,7.0,1,3
46,2,5,-3,-3,-6.0,-4,-1
47,1,3,-2,-2,15.0,-7,-5
48,6,8,-2,-2,-3.0,-2,4
49,6,8,-2,-2,7.0,1,5
50,9,4,5,5,-5.0,2,-2
51,5,8,-3,-3,2.0,-2,3
52,9,8,1,1,3.0,5,1
53,5,10,-5,-5,7.0,-3,6
54,6,5,1,1,-10.0,-4,-3
55,6,5,1,1,18.0,-2,-1
56,10,1,9,9,-3.0,2,-8
57,5,6,-1,-1,-8.0,-2,0
58,11,6,5,5,2.0,6,-3
59,9,6,3,3,3.0,4,-4
60,8,13,-5,-7,-11.0,0,3
61,8,8,0,-1,14.0,2,1
62,7,5,2,0,4.0,0,-6
63,5,6,-1,-2,1.0,-4,-4
64,2,7,-5,-5,-3.0,-8,-2
65,6,8,-2,-1,-8.0,-3,-1
66,6,12,-6,-4,-4.0,-1,6
67,11,12,-1,-1,-6.0,6,5
68,8,7,1,4,-11.0,1,0
69,6,5,1,2,-10.0,-4,-4
70,7,11,-4,-3,8.0,-4,1
71,13,5,8,5,-9.0,5,-7
72,8,11,-3,-3,16.0,-2,4
73,12,17,-5,-7,2.0,5,10
74,8,15,-7,-4,15.0,-2,7
75,5,9,-4,-5,-1.0,-8,-2
76,13,11,2,0,-2.0,2,3
77,9,9,0,4,0.0,-5,0
78,11,7,4,2,14.0,3,-4
79,10,9,1,-2,11.0,2,-5
80,7,8,-1,0,-8.0,-4,-5
81,5,8,-3,-3,15.0,-8,-2
82,20,8,12,9,-5.0,13,-7
83,9,12,-3,0,4.0,-3,2
84,12,13,-1,1,-12.0,2,-1
85,14,7,7,6,-9.0,5,-6
86,18,13,5,3,-3.0,10,4
87,14,11,3,3,-15.0,3,0
88,12,13,-1,-2,-11.0,2,3
89,11,20,-9,-7,14.0,0,13
90,15,17,-2,-1,-1.0,5,6
91,13,21,-8,-6,1.0,2,11
92,8,13,-5,-5,12.0,-7,3
93,8,8,0,-4,-8.0,-9,-7
94,9,11,-2,-1,0.0,-8,-1
95,7,17,-10,-11,-5.0,-7,8
96,16,7,9,5,12.0,0,-8
97,10,10,0,-1,-2.0,-3,-2
98,15,8,7,1,-15.0,5,-7
99,23,12,11,8,2.0,15,1
100,12,8,4,5,-18.0,-1,-10
101,16,10,6,3,6.0,6,-8
102,24,19,5,6,-9.0,12,2
103,18,10,8,6,-7.0,6,-4
104,17,13,4,5,10.0,7,1
105,16,10,6,8,2.0,1,-6
106,13,15,-2,3,10.0,-1,4
107,11,14,-3,1,-1.0,-6,-2
108,8,8,0,-1,-7.0,-8,-10
109,12,8,4,5,0.0,-1,-8
110,27,11,16,6,-12.0,13,-7
111,19,16,3,0,-9.0,6,1
112,10,11,-1,-3,-18.0,-10,-8
113,18,11,7,7,-8.0,5,-4
114,10,9,1,0,2.0,-7,-10
115,15,23,-8,-5,-2.0,2,13
116,14,17,-3,-7,-12.0,1,-1
117,19,19,0,-1,6.0,1,8
118,19,18,1,2,-3.0,3,7
119,23,19,4,-3,-9.0,13,3
120,12,15,-3,-1,8.0,-4,1
121,9,10,-1,1,0.0,-10,-11
122,20,15,5,0,6.0,8,-1
123,20,11,9,8,7.0,0,-7
124,14,22,-8,-5,17.0,-7,7
125,18,30,-12,-8,11.0,5,15
126,16,19,-3,0,10.0,0,5
127,10,20,-10,-2,-5.0,-10,1
128,11,14,-3,4,11.0,-9,0
129,26,20,6,2,-10.0,14,1
130,23,21,2,3,-8.0,11,6
131,17,11,6,5,9.0,-5,-8
132,22,17,5,-1,1.0,3,0
133,11,15,-4,-4,-8.0,-11,-2
134,15,15,0,6,0.0,-4,-1
135,20,23,-3,-4,-16.0,5,1
136,17,12,5,0,4.0,1,-8
137,30,13,17,7,-4.0,14,-8
138,11,22,-11,-2,14.0,-10,5
139,15,11,4,0,-7.0,-2,-10
140,13,26,-13,-7,-6.0,-8,12
141,26,12,14,12,16.0,2,-11
142,16,31,-15,-9,-3.0,-1,14
143,23,22,1,-3,-10.0,5,1
144,21,17,4,-5,-4.0,5,-6
145,17,32,-15,-2,8.0,-1,18
146,14,16,-2,1,7.0,-8,-4
147,14,20,-6,-1,9.0,-7,4
148,20,17,3,0,8.0,-4,-1
149,32,16,16,3,-6.0,18,-2
150,19,23,-4,3,-12.0,-3,-2
151,20,19,1,1,0.0,2,0
152,27,14,13,5,-1.0,12,-9
153,17,13,4,4,18.0,-8,-10
154,12,24,-12,-5,-14.0,-12,7
155,17,17,0,-3,-5.0,-3,-5
156,31,26,5,-1,2.0,13,7
157,25,29,-4,-6,-5.0,2,3
158,12,20,-8,-6,5.0,-13,0
159,19,25,-6,0,-3.0,1,2
160,14,23,-9,1,0.0,-10,3
161,20,31,-11,6,6.0,-4,12
162,29,30,-1,1,10.0,2,15
163,19,17,2,1,-4.0,-1,-4
164,29,35,-6,-2,-1.0,8,19
165,24,12,12,5,-1.0,6,-14
166,23,20,3,-1,10.0,1,-3
167,24,15,9,0,12.0,-2,-11
168,14,20,-6,-4,-11.0,-12,-6
169,19,15,4,3,8.0,-1,-11
170,23,23,0,3,-9.0,-2,-3
171,29,24,5,4,16.0,0,3
172,32,13,19,8,-14.0,10,-14
173,25,33,-8,-6,8.0,6,17
174,26,29,-3,0,-1.0,3,3
175,22,20,2,2,0.0,0,-5
176,14,31,-17,3,4.0,-15,10
177,27,35,-8,-2,10.0,0,17
178,14,17,-3,2,-4.0,-13,-5
179,35,25,10,2,-12.0,17,6
180,23,24,-1,-5,-9.0,-4,-2
181,34,22,12,4,-2.0,17,-1
182,20,27,-7,-7,-6.0,-2,3
183,32,22,10,3,11.0,5,-1
184,15,17,-2,0,-7.0,-14,-14
185,13,15,-2,-1,15.0,-17,-13
186,24,35,-11,-9,-1.0,2,13
187,31,32,-1,-8,-13.0,9,1
188,24,28,-4,-1,6.0,-3,0
189,23,32,-9,-1,-16.0,-4,1
190,18,32,-14,-5,-11.0,-12,4
191,37,28,9,0,-4.0,19,3
192,32,27,5,-6,3.0,9,3
193,24,22,2,1,10.0,-4,-3
194,26,35,-9,-7,13.0,4,12
195,18,21,-3,0,3.0,-14,-2
196,31,25,6,0,3.0,1,-2
197,16,39,-23,-3,-2.0,-14,19
198,14,22,-8,-4,15.0,-17,-3
199,22,26,-4,1,-6.0,-3,4
200,28,15,13,5,-15.0,3,-17
201,26,16,10,5,9.0,-2,-15
202,34,19,15,-1,16.0,1,-12
203,23,27,-4,-6,-18.0,-3,-2
204,24,38,-14,-4,-2.0,-1,19
205,35,25,10,3,1.0,10,-4
206,29,18,11,5,3.0,3,-15
207,42,33,9,8,-1.0,20,9
208,35,32,3,1,-1.0,5,1
209,42,38,4,-1,-4.0,20,19
210,25,19,6,1,8.0,-4,-14
211,29,29,0,1,-14.0,3,5
212,35,30,5,-4,-2.0,1,-1
213,27,25,2,5,4.0,1,-6
214,38,18,20,5,-6.0,12,-16
215,38,34,4,7,8.0,6,9
216,32,32,0,1,-2.0,4,0
217,19,23,-4,1,0.0,-14,-4
218,38,29,9,-1,-3.0,17,-1
219,34,25,9,-3,-5.0,9,-4
220,31,30,1,-5,14.0,-1,3
221,29,35,-6,-5,4.0,4,5
222,18,32,-14,-4,7.0,-17,4
223,16,41,-25,-8,-1.0,-18,13
224,17,39,-22,-6,4.0,-17,6
225,25,46,-21,-6,-2.0,-8,21
226,32,36,-4,-2,-4.0,-1,1
227,28,32,-4,4,-4.0,-2,-1
228,32,25,7,3,0.0,4,-8
229,29,20,9,0,9.0,-4,-14
230,36,19,17,2,9.0,0,-17
231,30,17,13,8,4.0,2,-18
232,44,41,3,2,-5.0,15,19
233,42,34,8,0,-7.0,8,0
234,36,35,1,5,7.0,5,8
235,49,17,32,9,-13.0,25,-19
236,27,30,-3,1,-14.0,-3,4
237,30,17,13,2,-6.0,-4,-19
238,42,21,21,4,11.0,8,-14
239,21,36,-15,2,-16.0,-14,0
240,41,31,10,-6,2.0,18,2
241,30,29,1,-3,6.0,3,-3
242,19,36,-17,-7,-3.0,-18,4
243,38,52,-14,-7,1.0,9,27
244,34,27,7,5,18.0,-2,-6
245,38,45,-7,-6,1.0,1,9
246,17,33,-16,-7,-9.0,-19,-2
247,17,34,-17,-4,15.0,-21,4
248,52,27,25,8,2.0,27,-6
249,21,26,-5,1,0.0,-15,-12
250,44,38,6,0,-6.0,19,0
251,42,31,11,1,12.0,2,1
252,37,20,17,6,18.0,1,-18
253,39,50,-11,-5,9.0,5,18
254,19,36,-17,-9,-2.0,-19,-1
255,32,34,-2,4,8.0,0,3
256,20,39,-19,-1,12.0,-20,9
257,26,50,-24,-14,-1.0,-14,18
258,26,44,-18,-5,-6.0,-14,19
259,34,39,-5,-4,-10.0,3,5
260,39,45,-6,0,-7.0,1,4
261,30,35,-5,-3,-8.0,-6,3
262,31,20,11,0,-11.0,-1,-23
263,42,31,11,6,-11.0,12,0
264,39,19,20,6,5.0,0,-21
265,21,24,-3,0,0.0,-18,-14
266,53,37,16,8,-17.0,19,0
267,49,56,-7,-2,9.0,10,28
268,30,21,9,2,0.0,-6,-18
269,24,53,-29,-10,-1.0,-14,19
270,42,35,7,6,1.0,2,2
271,48,37,11,5,6.0,21,1
272,45,39,6,5,6.0,3,2
273,34,52,-18,-9,-7.0,0,13
274,38,57,-19,-4,16.0,0,28
275,19,34,-15,-4,-7.0,-24,2
276,26,43,-17,-8,-3.0,-17,12
277,21,20,1,2,-15.0,-21,-24
278,42,33,9,1,12.0,3,-3
279,37,38,-1,-2,-18.0,1,0
280,34,19,15,7,-7.0,-3,-26
281,35,48,-13,-7,-2.0,2,4
282,55,48,7,6,5.0,14,20
283,39,21,18,-1,10.0,1,-22
284,23,43,-20,-2,3.0,-23,3
285,60,45,15,-4,-7.0,32,5
286,35,29,6,2,8.0,-1,-16
287,55,34,21,7,-3.0,19,-3
288,35,55,-20,-8,3.0,2,14
289,43,26,17,3,3.0,11,-14
290,35,58,-23,-5,7.0,-3,20
291,43,63,-20,-2,-2.0,3,34
292,45,55,-10,2,-2.0,3,13
293,49,26,23,1,1.0,4,-21
294,37,42,-5,4,-10.0,-2,2
295,34,38,-4,-5,-10.0,-4,3
296,19,26,-7,-5,7.0,-27,-16
297,38,32,6,-2,18.0,-5,-14
298,43,46,-3,-3,9.0,1,13
299,21,48,-27,-3,-6.0,-23,19
300,32,21,11,5,0.0,-15,-25
301,51,41,10,3,-12.0,21,-4
302,61,38,23,0,1.0,21,-2
303,41,45,-4,2,5.0,4,1
304,58,46,12,-2,11.0,15,5
305,43,35,8,1,2.0,2,-4
306,27,19,8,7,8.0,-21,-29
307,63,50,13,2,-14.0,32,4
308,49,34,15,7,-1.0,14,-5
309,29,43,-14,3,-12.0,-14,0
310,36,66,-30,-9,6.0,-4,33
311,32,41,-9,4,-18.0,-13,-9
312,46,34,12,4,5.0,1,-7
313,64,52,12,1,-2.0,24,16
314,42,21,21,11,14.0,4,-26
315,44,30,14,-5,-5.0,2,-19
316,19,54,-35,-9,1.0,-31,26
317,43,35,8,-5,12.0,-1,-14
318,50,61,-11,-7,5.0,3,19
319,38,46,-8,-4,0.0,-5,1
320,35,19,16,9,-7.0,-15,-32
321,49,46,3,8,-9.0,5,-4
322,57,35,22,-1,6.0,27,-11
323,37,46,-9,-1,-8.0,-2,0
324,52,38,14,4,3.0,12,-9
325,41,45,-4,-8,4.0,-11,7
326,61,67,-6,-4,10.0,18,28
327,21,53,-32,-8,-16.0,-29,4
328,31,37,-6,9,7.0,-19,-4
329,67,67,0,-3,1.0,33,28
330,47,42,5,0,-6.0,0,-11
331,38,60,-22,-9,2.0,-4,28
332,35,32,3,0,-15.0,-12,-19
333,46,38,8,-8,9.0,-5,-13
334,56,55,1,-4,13.0,5,14
335,38,61,-23,-2,-11.0,-11,14
336,70,52,18,3,1.0,32,6
337,46,68,-22,3,12.0,7,33
338,48,38,10,5,6.0,3,-2
339,19,21,-2,0,7.0,-34,-30
340,41,48,-7,3,-10.0,-11,2
341,52,38,14,-3,0.0,4,-11
342,60,56,4,5,-10.0,27,4
343,58,46,12,11,-6.0,15,-7
344,45,19,26,7,11.0,-9,-35
345,61,41,20,0,3.0,13,-3
346,24,47,-23,-1,-12.0,-29,-2
347,32,46,-14,-2,1.0,-20,5
348,38,41,-3,0,4.0,-3,-10
349,41,46,-5,1,-14.0,-11,5
350,39,72,-33,1,-2.0,-11,35
351,46,48,-2,-4,-1.0,-8,1
352,63,41,22,9,6.0,30,-12
353,56,42,14,-1,8.0,1,-3
354,41,53,-12,0,4.0,-1,4
355,19,62,-43,-4,-4.0,-38,13
356,24,61,-37,-9,-3.0,-30,16
357,48,35,13,-1,3.0,-6,-19
358,50,74,-24,-6,11.0,-1,34
359,42,19,23,7,1.0,-3,-38
360,56,24,32,7,0.0,5,-36
361,42,59,-17,-5,-16.0,-12,2
362,64,48,16,5,-15.0,22,-7
363,77,49,28,10,-8.0,36,-7
364,46,50,-4,-3,2.0,1,-3
365,65,47,18,-8,11.0,14,-7
366,49,40,9,-3,10.0,1,-11
367,38,64,-26,-2,9.0,-18,30
368,72,41,31,-1,-2.0,34,-2
369,72,49,23,1,-8.0,34,1
370,47,41,6,2,-15.0,-8,-17
371,41,49,-8,2,-14.0,-11,5
372,49,45,4,-4,9.0,-10,-10
373,64,64,0,-5,3.0,29,21
374,59,80,-21,-7,15.0,0,39
375,44,45,-1,-1,-4.0,-1,-3
376,51,49,2,6,8.0,-6,-4
377,19,75,-56,-8,5.0,-40,39
378,50,57,-7,-4,12.0,-7,5
379,25,68,-43,-3,-11.0,-36,15
410,3,5,-2,-2,-6.0,-2,2
411,5,7,-2,-2,-12.0,1,3
412,0,5,-5,-5,8.0,-7,3
413,4,4,0,0,7.0,-1,0
414,4,4,0,0,1.0,0,1
415,2,0,2,2,-2.0,-1,-6
416,9,0,9,9,5.0,7,-6
417,4,1,3,3,-1.0,-1,-9
418,7,3,4,4,13.0,3,-2
419,4,6,-2,-2,12.0,1,7
420,0,2,-2,-2,5.0,-10,-3
421,8,8,0,0,1.0,4,4
422,6,7,-1,-1,-9.0,2,0
423,4,8,-4,-4,9.0,-2,3
424,4,4,0,0,8.0,0,-1
425,5,8,-3,-3,3.0,1,3
426,4,0,4,4,8.0,-8,-10
427,4,10,-6,-6,-6.0,-1,7
428,7,5,2,2,8.0,0,1
429,7,10,-3,-3,-15.0,7,7
430,5,7,-2,-2,-5.0,-1,-2
431,4,5,-1,-1,7.0,-9,-1
432,9,5,4,4,-7.0,1,0
433,8,5,3,3,-15.0,3,0
434,8,5,3,3,3.0,0,-2
435,9,3,6,6,-6.0,3,-8
436,11,5,6,6,-14.0,5,-2
437,5,8,-3,-3,3.0,0,1
438,3,9,-6,-6,3.0,-7,4
439,8,4,4,4,-16.0,1,-9
440,11,8,3,3,-1.0,6,-1
441,8,5,3,3,-6.0,0,-9
442,5,11,-6,-6,18.0,-5,9
443,7,5,2,-1,8.0,-3,-5
444,6,6,0,0,1.0,-7,-5
445,8,11,-3,-1,6.0,1,7
446,12,6,6,5,-2.0,6,-1
447,6,10,-4,-3,7.0,-1,3
448,5,14,-9,-6,13.0,-4,8
449,11,12,-1,1,2.0,2,3
450,12,11,1,-3,12.0,6,0
451,9,7,2,-1,2.0,0,-7
452,13,5,8,4,-14.0,5,-10
453,5,10,-5,-4,3.0,-5,2
454,13,17,-4,-1,-3.0,3,9
455,6,14,-8,-5,10.0,-7,11
456,9,14,-5,-4,14.0,-1,9
457,15,7,8,9,-5.0,8,-1
458,9,5,4,4,3.0,0,-11
459,8,5,3,4,-10.0,0,-7
460,17,9,8,6,-9.0,13,-2
461,5,10,-5,-5,5.0,-9,0
462,11,15,-4,-6,7.0,2,7
463,5,16,-11,-9,18.0,-12,6
464,17,12,5,9,-13.0,11,4
465,8,6,2,0,-4.0,-9,-9
466,7,6,1,0,-5.0,-3,-5
467,18,14,4,2,-1.0,9,5
468,14,8,6,3,-5.0,4,-2
469,7,12,-5,-1,-5.0,-9,1
470,18,10,8,6,-6.0,8,-1
471,7,7,0,1,-7.0,-9,-5
472,11,14,-3,3,1.0,-8,4
473,18,12,6,10,-8.0,8,0
474,10,19,-9,-7,12.0,-1,8
475,14,14,0,1,11.0,3,2
476,8,7,1,-1,2.0,-3,-9
477,17,19,-2,-2,-2.0,10,9
478,12,18,-6,-6,16.0,-1,13
479,11,8,3,-2,-3.0,0,-9
480,7,15,-8,-4,13.0,-9,4
481,8,14,-6,-6,11.0,-5,-7
482,13,5,8,7,-10.0,4,-17
483,15,14,1,-2,1.0,1,1
484,5,12,-7,-3,3.0,-17,-3
485,11,7,4,6,-7.0,-7,-9
486,17,21,-4,-3,-4.0,4,9
487,7,13,-6,-4,1.0,-10,4
488,14,11,3,3,-6.0,-7,-2
489,19,10,9,4,-13.0,13,-3
490,18,8,10,5,-12.0,5,-6
491,23,17,6,0,-4.0,10,3
492,23,18,5,4,-1.0,10,8
493,21,11,10,4,-4.0,6,-8
494,14,23,-9,-3,8.0,4,10
495,7,7,0,1,8.0,-13,-11
496,14,20,-6,-1,9.0,0,7
497,18,6,12,6,-17.0,8,-17
498,17,19,-2,1,8.0,3,11
499,15,18,-3,0,9.0,1,5
500,8,16,-8,-1,2.0,-7,0
501,13,23,-10,-2,12.0,-4,8
502,14,15,-1,-5,7.0,-1,-9
503,16,17,-1,-6,3.0,0,2
504,19,17,2,-2,-4.0,5,5
505,9,16,-7,-2,5.0,-16,1
506,20,10,10,4,-15.0,5,-12
507,7,14,-7,-4,-3.0,-12,-1
508,15,17,-2,1,-2.0,-9,2
509,20,21,-1,-1,-2.0,11,10
510,24,23,1,-2,-3.0,8,6
511,29,16,13,9,-15.0,12,-2
512,15,8,7,6,-6.0,-4,-8
513,23,9,14,4,-12.0,6,-18
514,18,15,3,1,-2.0,5,-4
515,14,23,-9,-5,10.0,-2,6
516,10,29,-19,-8,17.0,-13,12
517,8,23,-15,-4,17.0,-8,13
518,21,20,1,-2,-3.0,8,5
519,16,15,1,-3,10.0,-2,-10
520,20,10,10,3,4.0,3,-13
521,19,25,-6,5,8.0,2,8
522,21,20,1,2,-7.0,3,1
523,23,15,8,4,-8.0,8,-2
524,15,23,-8,-1,-1.0,-11,4
525,15,21,-6,-5,5.0,-2,3
526,10,20,-10,-4,3.0,-14,1
527,19,20,-1,5,-2.0,2,3
528,10,10,0,2,9.0,-18,-13
529,32,16,16,5,-10.0,14,-4
530,21,16,5,1,-4.0,4,-11
531,29,24,5,7,-7.0,16,4
532,19,28,-9,-2,5.0,4,9
533,9,27,-18,-9,14.0,-10,7
534,19,23,-4,-1,11.0,-2,7
535,33,22,11,0,-11.0,14,4
536,21,13,8,-3,-16.0,4,-13
537,20,18,2,-3,2.0,0,-1
538,20,13,7,0,-4.0,1,-13
539,19,21,-2,5,9.0,-3,4
540,30,19,11,5,-6.0,8,3
541,16,20,-4,2,-6.0,-7,-2
542,24,23,1,-2,-4.0,2,4
543,19,30,-11,-6,6.0,-10,16
544,24,33,-9,-4,4.0,7,10
545,29,13,16,-1,-15.0,9,-20
546,24,9,15,2,-10.0,3,-11
547,30,30,0,1,-3.0,16,8
548,29,23,6,-2,-10.0,9,2
549,21,19,2,3,4.0,1,3
550,13,27,-14,-2,11.0,-19,4
551,32,33,-1,-4,1.0,10,10
552,14,20,-6,0,13.0,-20,-10
553,27,16,11,-3,-8.0,10,-12
554,20,23,-3,0,2.0,-4,1
555,27,9,18,9,-9.0,6,-12
556,27,21,6,3,-10.0,11,-1
557,33,30,3,-3,1.0,9,14
558,30,27,3,2,-5.0,14,11
559,27,33,-6,-2,6.0,4,9
560,22,23,-1,-3,-7.0,4,-3
561,21,32,-11,-6,11.0,-5,9
562,23,30,-7,-3,12.0,0,15
563,24,22,2,-2,-1.0,0,-1
564,12,15,-3,-2,-2.0,-11,-20
565,36,19,17,9,-8.0,11,-9
566,19,27,-8,0,2.0,-11,5
567,21,16,5,0,-12.0,-10,-17
568,33,19,14,6,-11.0,15,-9
569,27,27,0,-5,-1.0,2,5
570,22,16,6,-3,-9.0,1,-21
571,21,15,6,-4,-4.0,-8,-22
572,23,23,0,-5,1.0,-2,-1
573,15,26,-11,-4,1.0,-9,0
574,39,30,9,8,-2.0,14,14
575,19,35,-16,-1,6.0,-12,12
576,24,37,-13,4,5.0,-6,10
577,24,33,-9,-7,10.0,-1,17
578,23,15,8,2,-4.0,-1,-9
579,30,19,11,-2,-5.0,14,-12
580,38,25,13,1,-2.0,13,-6
581,38,22,16,3,-14.0,10,-8
582,22,23,-1,0,-3.0,-9,-5
583,26,28,-2,3,9.0,-5,1
584,28,22,6,1,-1.0,4,0
585,19,27,-8,1,6.0,-20,0
586,36,39,-3,3,-1.0,18,13
587,22,38,-16,4,9.0,-10,10
588,28,19,9,-2,-11.0,1,-20
589,22,26,-4,-5,-4.0,0,2
590,23,33,-10,-6,10.0,-8,13
591,23,27,-4,-7,-2.0,-6,-5
592,30,22,8,4,1.0,1,-10
593,18,31,-13,2,9.0,-5,5
594,39,41,-2,-3,-1.0,11,16
595,25,16,9,3,-13.0,-9,-23
596,40,38,2,5,-1.0,17,8
597,25,39,-14,-6,8.0,-8,20
598,19,18,1,-3,1.0,-21,-5
599,16,39,-23,-6,16.0,-23,11
600,39,25,14,-3,-9.0,8,-10
601,42,25,17,9,-7.0,22,2
602,23,24,-1,1,-4.0,-10,-8
603,27,31,-4,-1,4.0,-6,1
604,31,26,5,1,-6.0,4,-5
605,34,28,6,-1,-1.0,13,-8
606,41,41,0,-2,4.0,14,17
607,29,32,-3,2,6.0,0,2
608,42,39,3,9,1.0,22,8
609,17,41,-24,-8,19.0,-23,17
610,25,45,-20,-11,13.0,-8,23
611,29,19,10,4,-5.0,-1,-24
612,28,26,2,-2,5.0,-6,-9
613,35,27,8,4,-7.0,3,-5
614,25,44,-19,-8,9.0,1,19
615,37,42,-5,-3,1.0,17,14
616,24,31,-7,5,5.0,-2,0
617,40,17,23,2,-18.0,8,-25
618,26,28,-2,0,4.0,-10,-12
619,32,43,-11,-2,5.0,4,13
620,47,29,18,1,-10.0,20,-8
621,19,32,-13,-2,10.0,-25,2
622,28,27,1,-7,-3.0,-5,-1
623,32,36,-4,-1,5.0,0,3
624,17,40,-23,-8,14.0,-26,19
625,45,28,17,10,-14.0,22,-7
626,46,25,21,3,-12.0,15,-12
627,28,25,3,1,-3.0,-14,0
628,42,43,-1,1,3.0,12,9
629,27,32,-5,-1,-2.0,-9,0
630,37,43,-6,-1,2.0,3,20
631,25,31,-6,-3,9.0,-13,-12
632,22,28,-6,1,2.0,-24,-10
633,35,25,10,5,3.0,2,-2
634,30,46,-16,4,16.0,0,10
635,28,42,-14,2,7.0,-9,8
636,49,30,19,2,-7.0,16,-8
637,32,17,15,3,-11.0,1,-27
638,33,48,-15,-5,11.0,0,26
639,28,48,-20,-4,14.0,-6,20
640,31,35,-4,4,-1.0,-8,1
641,51,35,16,6,-12.0,21,1
642,17,22,-5,-2,1.0,-28,-25
643,49,28,21,6,-13.0,14,-7
644,51,38,13,3,-5.0,29,3
645,30,28,2,0,-5.0,-10,-12
646,31,31,0,-3,-5.0,-13,-8
647,43,33,10,-2,-9.0,8,-2
648,31,52,-21,-9,13.0,-9,18
649,38,31,7,3,1.0,3,-13
650,29,26,3,4,6.0,-12,-4
651,34,44,-10,-5,8.0,-2,19
652,35,52,-17,-9,11.0,-2,20
653,30,31,-1,3,7.0,-8,-10
654,31,17,14,8,-8.0,-9,-31
655,55,54,1,0,3.0,19,24
656,38,31,7,3,-8.0,3,-10
657,25,54,-29,-6,16.0,-22,31
658,29,44,-15,0,10.0,-7,8
659,54,25,29,7,-18.0,24,-22
660,29,41,-12,-2,2.0,-1,3
661,31,30,1,-2,1.0,-11,-12
662,47,35,12,6,-7.0,20,-4
663,45,30,15,-3,-13.0,8,-10
664,53,55,-2,1,-2.0,20,17
665,57,38,19,6,-6.0,32,-1
666,34,34,0,0,-1.0,-8,-8
667,34,30,4,3,-8.0,-13,-7
668,17,37,-20,-8,6.0,-32,-1
669,29,30,-1,-2,-8.0,-1,-10
670,50,38,12,4,-3.0,24,-5
671,30,26,4,-2,-3.0,-13,-23
672,50,34,16,4,-11.0,24,-10
673,30,35,-5,-1,2.0,-8,-5
674,35,56,-21,-5,10.0,-8,22
675,55,30,25,6,-14.0,14,-11
676,35,18,17,5,-9.0,-8,-32
677,37,58,-21,-4,4.0,-12,32
678,41,60,-19,-8,7.0,0,27
679,48,32,16,-1,-5.0,10,0
680,38,41,-3,-2,-5.0,-6,0
681,41,30,11,3,-2.0,0,-15
682,29,33,-4,2,4.0,-21,-7
683,31,41,-10,-3,10.0,-11,-1
684,19,51,-32,-7,15.0,-32,12
685,61,35,26,6,-9.0,36,-9
686,34,36,-2,0,6.0,-14,-8
687,35,38,-3,-6,4.0,-6,-6
688,59,53,6,3,-4.0,25,28
689,56,33,23,2,-11.0,14,-7
690,66,35,31,11,-16.0,31,-14
691,33,42,-9,1,8.0,-14,-1
692,53,29,24,2,-13.0,27,-22
693,54,64,-10,-2,2.0,14,38
694,19,32,-13,-5,10.0,-34,-3
695,62,41,21,5,-12.0,26,-1
696,38,41,-3,1,3.0,-8,-4
697,37,35,2,7,-2.0,-8,-8
698,40,32,8,7,-11.0,-12,-11
699,32,37,-5,0,-1.0,-3,-8
700,41,69,-28,-8,13.0,-3,34
701,29,39,-10,-4,7.0,-23,-8
702,36,36,0,0,-1.0,-10,-13
703,36,43,-7,-8,6.0,-8,-11
704,32,56,-24,-10,12.0,-13,28
705,35,22,13,-1,-3.0,-17,-33
706,42,54,-12,-6,4.0,-4,13
707,42,60,-18,-1,4.0,-2,18
708,69,42,27,11,-8.0,34,-4
709,36,32,4,5,-2.0,-13,-13
710,57,39,18,1,-9.0,28,-8
711,22,67,-45,-5,17.0,-34,38
712,42,43,-1,6,4.0,-7,-2
713,38,29,9,1,-8.0,-10,-24
714,46,41,5,8,-7.0,-9,-6
715,54,38,16,2,-12.0,12,-16
716,61,36,25,5,-9.0,18,-9
717,36,57,-21,-3,4.0,-1,28
718,43,54,-11,-7,3.0,-2,12
719,41,38,3,0,3.0,-6,-10
720,29,64,-35,-6,15.0,-26,19
721,39,22,17,5,-5.0,-11,-35
722,38,71,-33,-11,15.0,-18,30
723,45,47,-2,-3,2.0,-4,-9
724,39,45,-6,2,7.0,-12,-4
725,60,70,-10,-2,3.0,31,39
726,57,37,20,7,-8.0,14,-9
727,22,43,-21,2,12.0,-35,-3
728,71,29,42,12,-17.0,30,-26
729,45,39,6,3,2.0,-6,1
730,67,42,25,10,-10.0,22,-8
731,42,40,2,-1,-4.0,-8,-11
732,50,38,12,9,-10.0,-6,-19
733,78,33,45,13,-17.0,39,-18
734,40,67,-27,-3,6.0,1,22
735,40,40,0,-5,-3.0,-8,-12
736,78,50,28,2,-6.0,39,-6
737,33,45,-12,-8,6.0,-18,-8
738,43,42,1,-4,-3.0,-4,-8
739,42,38,4,-3,-3.0,-8,-19
740,29,60,-31,-6,14.0,-29,14
741,43,24,19,3,-7.0,-5,-35
742,36,76,-40,-8,15.0,-17,43
743,45,61,-16,-1,6.0,-9,28
744,68,50,18,-1,-3.0,22,-8
745,47,74,-27,-6,7.0,-4,31
746,43,43,0,-4,5.0,-10,2
747,40,81,-41,-8,15.0,-15,41
748,74,43,31,1,-8.0,31,2
749,76,81,-5,-3,2.0,43,41
750,84,43,41,8,-14.0,42,-11
751,43,44,-1,0,-3.0,1,-5
752,64,47,17,3,-2.0,30,-3
753,63,45,18,3,-7.0,15,-11
754,25,50,-25,-5,11.0,-35,-3
755,77,36,41,8,-16.0,32,-18
756,76,43,33,10,-11.0,42,-11
757,42,71,-29,-7,7.0,-10,24
758,39,29,10,4,-2.0,-22,-30
759,50,40,10,3,-9.0,-10,-17
790,5,4,1,1,1.0,2,1
791,3,1,2,2,2.0,-2,-3
792,4,4,0,0,3.0,0,1
793,3,2,1,1,4.0,-1,-1
794,4,6,-2,-2,2.0,0,3
795,6,6,0,0,-3.0,0,1
796,2,4,-2,-2,-11.0,-1,1
797,5,4,1,1,0.0,1,-1
798,4,2,2,2,-11.0,-1,-2
799,4,6,-2,-2,-2.0,1,3
800,6,7,-1,-1,-15.0,-2,2
801,4,5,-1,-1,-16.0,-2,-1
802,8,3,5,5,-8.0,2,-1
803,7,6,1,1,-4.0,1,-2
804,8,4,4,4,-19.0,8,-2
805,5,4,1,1,4.0,1,0
806,9,5,4,4,-1.0,3,0
807,3,4,-1,-1,-12.0,-1,-1
808,7,2,5,5,-8.0,1,-3
809,7,6,1,1,2.0,3,-2
810,8,5,3,3,16.0,1,-5
811,5,10,-5,-5,2.0,-1,2
812,7,11,-4,-4,6.0,1,11
813,7,4,3,3,15.0,1,-3
814,3,10,-7,-7,5.0,-2,3
815,4,4,0,0,20.0,-5,-1
816,6,11,-5,-5,4.0,0,3
817,6,5,1,1,-2.0,-3,0
818,2,10,-8,-8,13.0,-4,2
819,5,3,2,2,-8.0,-5,-2
820,7,3,4,4,-18.0,-3,-4
821,4,8,-4,-2,-15.0,-2,1
822,7,11,-4,-4,-2.0,-2,4
823,11,7,4,4,-15.0,2,-4
824,14,6,8,8,-3.0,13,-2
825,6,9,-3,-5,-5.0,0,1
826,10,8,2,5,-9.0,1,0
827,10,7,3,0,1.0,1,-3
828,14,7,7,6,-7.0,5,-1
829,9,4,5,5,16.0,1,-2
830,11,7,4,4,12.0,1,-6
831,8,8,0,-2,7.0,-1,-2
832,11,11,0,-2,5.0,2,1
833,8,10,-2,-2,6.0,-3,0
834,9,7,2,5,-3.0,1,0
835,6,5,1,4,18.0,-1,-8
836,12,15,-3,-2,1.0,4,13
837,7,12,-5,-5,-1.0,-2,2
838,8,15,-7,-6,20.0,-4,5
839,12,12,0,-1,-14.0,4,4
840,8,11,-3,-5,-10.0,-6,0
841,8,9,-1,-3,-1.0,-4,-1
842,11,7,4,1,-18.0,1,-1
843,14,12,2,-1,3.0,4,1
844,16,15,1,1,-1.0,5,12
845,8,6,2,3,9.0,-4,-8
846,9,10,-1,0,16.0,-4,1
847,5,12,-7,-5,-5.0,-5,-1
848,10,13,-3,-1,8.0,2,1
849,6,11,-5,-5,0.0,-8,1
850,12,10,2,3,1.0,-1,0
851,10,11,-1,0,4.0,0,-5
852,15,16,-1,0,5.0,3,2
853,18,14,4,3,-14.0,15,1
854,16,9,7,2,-4.0,3,-4
855,11,5,6,2,10.0,-1,-9
856,8,18,-10,-5,16.0,-1,6
857,13,12,1,0,-4.0,3,-3
858,10,11,-1,2,-1.0,-1,-2
859,18,11,7,6,-7.0,6,-2
860,16,15,1,-2,4.0,4,0
861,13,14,-1,3,-6.0,5,1
862,15,10,5,6,-11.0,3,-1
863,16,5,11,4,0.0,1,-11
864,21,10,11,3,-7.0,18,-3
865,13,11,2,5,20.0,-3,-10
866,8,16,-8,0,15.0,-2,2
867,6,15,-9,-7,-15.0,-12,1
868,18,12,6,3,-2.0,4,-3
869,15,6,9,9,12.0,0,-12
870,11,24,-13,-6,-1.0,-11,23
871,18,21,-3,0,10.0,2,6
872,14,19,-5,2,9.0,-5,2
873,10,24,-14,-9,9.0,-2,12
874,16,18,-2,-5,3.0,1,4
875,10,16,-6,-6,4.0,-8,8
876,14,16,-2,-5,-10.0,-2,-2
877,12,19,-7,-5,-9.0,-5,5
878,5,11,-6,-7,-18.0,-12,-1
879,24,5,19,12,2.0,12,-12
880,22,17,5,4,6.0,7,-1
881,7,12,-5,-2,-7.0,-14,-6
882,18,18,0,3,-12.0,3,1
883,22,19,3,-2,-3.0,3,2
884,27,10,17,9,-10.0,24,-3
885,16,13,3,4,12.0,-3,-7
886,12,14,-2,0,9.0,-1,-6
887,16,19,-3,1,-11.0,7,2
888,21,11,10,5,5.0,5,-12
889,18,16,2,-2,8.0,1,7
890,7,7,0,1,0.0,-12,-15
891,15,28,-13,-6,5.0,-5,13
892,19,15,4,-3,-3.0,1,2
893,14,30,-16,-9,8.0,-9,25
894,10,23,-13,-7,11.0,-4,3
895,20,17,3,-1,-17.0,2,-3
896,14,22,-8,-5,-8.0,-7,5
897,17,24,-7,-6,5.0,-3,8
898,11,21,-10,-7,0.0,-15,5
899,18,17,1,-2,-8.0,-1,-3
900,11,23,-12,-10,-16.0,-16,5
901,10,33,-23,-10,-1.0,-10,26
902,18,17,1,2,3.0,-3,5
903,14,24,-10,-9,9.0,-10,6
904,10,7,3,-1,11.0,-7,-17
905,17,18,-1,-3,-10.0,-5,3
906,20,26,-6,-1,10.0,-2,6
907,22,28,-6,-2,13.0,2,11
908,20,24,-4,-5,-2.0,1,7
909,28,17,11,3,-6.0,11,-5
910,24,23,1,1,13.0,5,2
911,8,12,-4,1,0.0,-17,-16
912,27,10,17,7,0.0,7,-13
913,26,22,4,3,-15.0,3,0
914,24,21,3,0,-7.0,6,0
915,36,23,13,6,-9.0,29,1
916,21,11,10,12,7.0,4,-7
917,17,14,3,4,-5.0,4,-11
918,23,21,2,1,13.0,-1,-2
919,28,23,5,0,-1.0,10,2
920,11,23,-12,-5,-10.0,-16,-1
921,21,39,-18,-9,11.0,-3,31
922,20,13,7,-4,4.0,5,-12
923,14,21,-7,-9,2.0,-12,-4
924,17,22,-5,3,-7.0,-7,-1
925,26,11,15,9,9.0,1,-8
926,24,25,-1,7,2.0,5,5
927,12,29,-17,-9,0.0,-17,5
928,27,27,0,-3,5.0,9,6
929,25,14,11,6,7.0,5,-12
930,13,15,-2,3,0.0,-15,-16
931,21,25,-4,-4,-11.0,-9,5
932,30,20,10,5,-8.0,7,-6
933,25,29,-4,-7,-5.0,1,2
934,29,22,7,3,-12.0,4,-3
935,11,23,-12,-6,7.0,-9,8
936,24,12,12,0,3.0,-3,-16
937,40,27,13,7,-4.0,31,8
938,24,34,-10,0,8.0,-1,16
939,15,20,-5,-3,-8.0,-16,-6
940,22,22,0,-3,5.0,-5,-9
941,23,12,11,1,4.0,7,-17
942,16,27,-11,2,-3.0,-14,-2
943,25,29,-4,-1,-1.0,0,6
944,32,26,6,-2,-18.0,6,5
945,30,35,-5,-1,3.0,9,16
946,40,33,7,-2,1.0,30,9
947,29,18,11,8,11.0,0,-7
948,25,14,11,4,-1.0,-1,-8
949,35,32,3,-2,2.0,16,6
950,29,43,-14,-4,15.0,5,32
951,12,32,-20,-7,-20.0,-20,1
952,22,16,6,-1,7.0,-10,-17
953,33,26,7,0,-4.0,7,10
954,18,19,-1,-5,9.0,-8,-12
955,15,33,-18,-4,6.0,-8,13
956,27,25,2,4,-12.0,-4,-1
957,26,25,1,4,6.0,4,-4
958,21,26,-5,-2,-2.0,-8,-1
959,35,32,3,-5,-18.0,12,1
960,34,26,8,4,-10.0,7,-3
961,19,25,-6,1,-3.0,-8,-9
962,18,19,-1,0,11.0,-7,-16
963,30,46,-16,-3,2.0,-3,33
964,24,20,4,-3,8.0,-6,-12
965,25,38,-13,-6,10.0,-9,17
966,27,29,-2,5,-12.0,10,4
967,19,19,0,2,-9.0,-16,-8
968,20,22,-2,9,-7.0,-12,-11
969,26,18,8,-3,4.0,-1,-7
970,35,15,20,2,0.0,1,-22
971,36,27,9,-1,-3.0,13,-5
972,47,29,18,3,-17.0,33,7
973,36,37,-1,0,20.0,4,10
974,26,31,-5,-4,7.0,-6,-3
975,39,30,9,-2,-2.0,17,11
976,29,36,-7,-5,11.0,1,13
977,15,47,-32,-4,-1.0,-22,33
978,22,26,-4,-2,-3.0,-12,-6
979,19,29,-10,-2,-6.0,-11,3
980,20,23,-3,-1,11.0,-7,-12
981,31,21,10,1,3.0,-5,-16
982,27,31,-4,-2,-4.0,-6,-5
983,29,39,-10,-6,-2.0,5,7
984,37,35,2,1,0.0,7,-1
985,31,37,-6,1,4.0,11,7
986,21,23,-2,4,-7.0,-16,-12
987,23,20,3,7,-9.0,-12,-11
988,29,31,-2,-3,12.0,1,-5
989,35,39,-4,1,-2.0,-1,16
990,40,23,17,1,-6.0,16,-3
991,53,29,24,13,-15.0,38,-2
992,30,28,2,-3,2.0,-4,-6
993,42,16,26,9,20.0,9,-25
994,32,30,2,6,-6.0,-5,5
995,29,32,-3,-7,1.0,-2,2
996,40,16,24,1,2.0,16,-25
997,32,23,9,3,12.0,-5,-16
998,34,34,0,4,1.0,14,-3
999,26,23,3,-5,-4.0,-10,-3
1000,35,21,14,5,15.0,3,-20
1001,21,41,-20,-5,4.0,-15,16
1002,29,36,-7,7,8.0,-6,-2
1003,43,56,-13,-2,19.0,9,40
1004,31,31,0,0,8.0,5,-4
1005,16,32,-16,1,-16.0,-27,1
1006,21,41,-20,-1,-2.0,-20,16
1007,24,43,-19,-6,-20.0,-16,9
1008,40,35,5,-3,-15.0,6,3
1009,36,37,-1,-10,-4.0,-2,16
1010,44,31,13,9,-13.0,19,2
1011,59,27,32,8,-6.0,41,-11
1012,25,22,3,4,2.0,-3,-15
1013,32,36,-4,-5,-2.0,-4,-4
1014,27,38,-11,-7,-8.0,-11,4
1015,44,40,4,0,2.0,18,5
1016,33,25,8,-3,5.0,1,-3
1017,37,59,-22,-3,3.0,15,41
1018,27,39,-12,1,7.0,-11,-1
1019,38,24,14,8,15.0,4,-17
1020,23,33,-10,-3,-1.0,-15,-4
1021,35,16,19,7,8.0,-3,-32
1022,43,45,-2,-2,15.0,7,19
1023,37,37,0,3,9.0,-4,-5
1024,32,21,11,2,18.0,2,-22
1025,16,32,-16,-2,-18.0,-32,2
1026,21,37,-16,-8,-12.0,-22,-4
1027,27,33,-6,3,-16.0,-16,0
1028,40,28,12,-3,-7.0,4,-11
1029,39,43,-4,-3,-20.0,-2,7
1030,27,38,-11,-4,3.0,-3,-2
1031,37,23,14,3,-6.0,-6,-16
1032,36,40,-4,-4,-5.0,-3,4
1033,63,50,13,2,-1.0,42,20
1034,50,35,15,5,-16.0,20,3
1035,22,39,-17,-7,-4.0,-22,15
1036,28,36,-8,-2,-10.0,-16,-3
1037,31,37,-6,2,4.0,-10,-6
1038,40,63,-23,-2,14.0,4,42
1039,42,45,-3,1,-5.0,0,17
1040,26,41,-15,-7,1.0,-15,-1
1041,27,41,-14,-5,-1.0,-4,-2
1042,46,16,30,6,0.0,8,-35
1043,44,37,7,-6,4.0,5,1
1044,35,42,-7,-3,14.0,0,17
1045,37,46,-9,2,16.0,1,8
1046,16,26,-10,-6,-9.0,-35,-15
1047,41,43,-2,-2,-3.0,-2,5
1048,42,44,-2,6,-16.0,17,5
1049,66,45,21,4,1.0,47,2
1050,38,28,10,-3,-8.0,-7,-4
1051,44,32,12,10,1.0,0,-12
1052,36,24,12,2,10.0,-5,-22
1053,35,46,-11,-2,18.0,-2,7
1054,38,53,-15,-6,14.0,1,18
1055,49,34,15,-2,5.0,19,-14
1056,53,36,17,7,-8.0,18,-5
1057,17,38,-21,0,-3.0,-35,-7
1058,42,28,14,1,-7.0,15,-4
1059,24,34,-10,-7,0.0,-22,-14
1060,50,70,-20,-5,4.0,19,49
1061,27,41,-14,-3,-7.0,-16,3
1062,48,47,1,-4,5.0,7,6
1063,35,32,3,-1,11.0,-3,-13
1064,42,45,-3,0,12.0,-3,-2
1065,44,49,-5,3,8.0,-3,8
1066,41,45,-4,2,16.0,3,-2
1067,41,35,6,4,-2.0,3,-3
1068,35,45,-10,3,-4.0,-14,16
1069,47,44,3,-3,7.0,6,-3
1070,45,27,18,0,0.0,-3,-23
1071,35,27,8,3,-2.0,-11,-18
1072,31,48,-17,0,-9.0,-4,5
1073,52,50,2,7,-5.0,11,18
1074,70,45,25,0,-11.0,47,-1
1075,39,18,21,4,10.0,-4,-36
1076,27,57,-30,-6,7.0,-18,20
1077,18,45,-27,-6,-12.0,-36,-1
1078,50,50,0,-6,-10.0,18,8
1079,57,31,26,5,-9.0,20,-4
1080,45,38,7,4,9.0,4,-9
1081,51,44,7,6,-4.0,21,-6
1082,53,42,11,5,-3.0,11,-7
1083,45,27,18,-1,-9.0,-5,-20
1084,73,30,43,2,1.0,48,-21
1085,49,42,7,-1,10.0,5,-3
1086,36,35,1,-6,18.0,-5,-20
1087,30,49,-19,3,-20.0,-21,5
1088,35,45,-10,4,0.0,-20,-5
1089,38,53,-15,-1,2.0,-9,19
1090,35,56,-21,-2,11.0,-1,12
1091,43,39,4,1,-15.0,-7,-3
1092,45,48,-3,-7,-4.0,-4,5
1093,45,54,-9,-3,6.0,-2,24
1094,60,38,22,3,-5.0,21,-10
1095,48,45,3,7,8.0,5,-6
1096,24,35,-11,4,0.0,-32,-22
1097,54,45,9,8,-8.0,24,-4
1098,56,30,26,3,0.0,12,-23
1099,45,35,10,-8,-11.0,-6,-1
1100,77,30,47,6,-8.0,50,-23
1101,49,46,3,-4,17.0,3,-6
1102,39,59,-20,-11,3.0,-4,13
1103,59,45,14,1,-5.0,23,-5
1104,33,59,-26,-1,-5.0,-22,23
1105,38,63,-25,-6,-2.0,-20,24
1106,38,24,14,-1,7.0,-11,-33
1107,59,54,5,3,11.0,13,23
1108,30,39,-9,0,-9.0,-23,-4
1109,35,77,-42,-3,10.0,-2,50
1110,47,45,2,8,3.0,-6,-11
1111,46,50,-4,0,-12.0,-7,3
1112,45,50,-5,-3,-6.0,-7,5
1113,49,62,-13,-6,12.0,-3,15
1114,24,62,-38,-6,-5.0,-35,25
1115,47,46,1,6,-5.0,-6,-7
1116,66,62,4,-3,-13.0,25,15
1117,50,33,17,0,16.0,5,-24
1118,24,38,-14,-1,-11.0,-35,1
1119,54,38,16,3,-3.0,21,-14
1120,45,46,-1,-7,-10.0,-12,-7
1121,65,47,18,7,2.0,28,-9
1122,80,38,42,7,1.0,51,-23
1123,53,52,1,-2,8.0,4,-2
1124,39,46,-7,2,10.0,-7,-10
1125,62,34,28,3,-9.0,14,-22
1126,65,57,8,6,1.0,28,22
1127,62,25,37,5,15.0,14,-35
1128,46,80,-34,-8,7.0,-10,51
1129,47,69,-22,-4,1.0,-9,26
1130,52,66,-14,-6,7.0,-3,28
1131,33,25,8,-1,0.0,-27,-40
1132,41,65,-24,-6,0.0,-22,15
1133,41,56,-15,-4,-13.0,-14,5
1134,65,48,17,9,15.0,19,-10
1135,34,58,-24,0,5.0,-23,22
1136,39,42,-3,1,-7.0,-1,-4
1137,48,54,-6,-3,-13.0,-9,6
1138,49,70,-21,-5,6.0,-9,26
1139,46,80,-34,-3,9.0,-9,50
